XXXXXXXXXXXXXXXXXXXXXXXXXX
X000000000000000000000000X
X000000000000000000000000X
X000000000XXXXX0000000000X
X000000000XXXXX0000000000X
X000000000XXXXX0000000000X
X000000000XXXXX0000000000X
X000000000XXXXX0000000000X
X000000000XXXXX0000000000X
X000000000XXXXX0000000000X
X000000000XXXXX0000000000X
X000000000XXXXX0000000000X
X0000S0000XXXXX000000G000X
X000000000XXXXXXXXXXXXXXXX
X000000000XXXXX0000000000X
X000000000XXXXX0000000000X
X000000000XXXXX0000000000X
X000000000XXXXX0000000000X
X000000000XXXXX0000000000X
X000000000XXXXX0000000000X
X000000000XXXXX0000000000X
X000000000XXXXX0000000000X
X000000000000000000000000X
X000000000000000000000000X
XXXXXXXXXXXXXXXXXXXXXXXXXX
